t,stage,challenge,score,lives,player_x,player_vx,enemies,attackers,enemy_bullets,player_bullets,challenge_enemies
0,6,0,0,3,140,0,40,0,0,0,0
1,6,0,50,3,53.14,-247.06,39,0,0,2,0
2,6,0,150,3,9,0,37,0,1,2,0
3,6,0,150,3,190.87,247.99,37,3,1,1,0
4,6,0,280,3,271,0,35,4,1,2,0
5,6,0,280,3,271,0,35,2,2,2,0
6,6,0,440,3,271,0,34,1,2,1,0
7,6,0,440,2,271,0,34,0,1,0,0
8,6,0,440,2,271,0,34,0,0,0,0
