t,stage,challenge,score,lives,player_x,player_vx,enemies,attackers,enemy_bullets,player_bullets,challenge_enemies
0,8,0,0,4,140,0,40,0,0,0,0
1,8,0,80,4,235.11,247.4,39,0,0,2,0
2,8,0,290,4,266.67,-121.02,36,0,1,2,0
3,8,0,340,4,9,0,35,1,2,2,0
4,8,0,340,4,9,0,35,1,1,2,0
5,8,0,340,4,128.88,247.84,35,1,1,2,0
6,8,0,390,4,271,0,34,1,1,2,0
7,8,0,390,4,271,0,34,2,1,2,0
8,8,0,390,4,271,0,34,2,1,2,0
9,8,0,490,4,271,0,33,2,2,0,0
10,8,0,490,4,271,0,33,2,2,0,0
