t,stage,challenge,score,lives,player_x,player_vx,enemies,attackers,enemy_bullets,player_bullets,challenge_enemies
0,12,0,0,5,140,0,40,0,0,0,0
1,12,0,50,5,77.76,-244.43,39,0,0,2,0
2,12,0,180,5,9,0,37,0,1,2,0
3,12,0,180,5,91.74,246.83,37,1,1,2,0
4,12,0,280,5,271,0,35,2,1,2,0
5,12,0,280,5,271,0,35,5,2,2,0
6,12,0,440,5,89.13,-247.99,34,3,3,2,0
7,12,0,540,5,9,0,32,2,1,2,0
8,12,0,540,5,9,0,32,2,1,2,0
9,12,0,540,5,9,0,32,4,2,0,0
10,12,0,540,5,9,0,32,4,3,0,0
